Map
 ##### 
 #...# 
 ....# 
 #...# 
 ##### 
       
Portal 0 2 2 5 3

Map
       
 ##### 
 #...# 
 #.... 
 #...# 
 #...# 
 #...# 
 #.#.# 
 #...# 
 #...# 
 #c..# 
 ##### 
       
Portal 2 6 1 1 2
