 #########-INVENTORY-#########
 #...|...|...|...|...|...|...#
 #...|...|...|...|...|...|...#
 #...|...|...|...|...|...|...#
 #...|...|...|...|...|...|...#
 #...|...|...|...|...|...|...#
 #...|...|...|...|...|...|...#
 ############################# 