################################################## 
#####........................................##### 
#####...............THE.END..................##### 
#####........................................##### 
################################################## 
################################################## 
################################################## 
################################################## 
################################################## 
#####........................................##### 
#####........................................##### 
#####........................................##### 
#####......########.##......#..########......##### 
#####......#........#.#.....#..#.......#.....##### 
#####......#........#..#....#..#.......#.....##### 
#####......######...#....#..#..#.......#.....##### 
#####......#........#.....#.#..#.......#.....##### 
#####......#........#......##..#.......#.....##### 
#####......########.#......##..########......##### 
#####........................................##### 
#####........................................##### 
#####........................................##### 
#####........................................##### 
#####...Creditos.............................##### 
#####......Danilo............................##### 
#####......Felipe............................##### 
#####......Gustavo...........................##### 
#####......Hudwesley.........................##### 
#####......Joao..............................##### 
#####......Joao Colem........................##### 
#####......Lucas Costa.......................##### 
#####......Victor............................##### 
#####........................................##### 
#####........................................##### 
#####........................................##### 
#####........................................##### 
#####........................................##### 
#####........................................##### 
#####........................................##### 
################################################## 
################################################## 
################################################## 
################################################## 
################################################## 
################################################## 
################################################## 
################################################## 
################################################## 
################################################## 
################################################## 